20 15
11111111111111111111
103030111333300330B1
10003011100033311101
13300303030033330011
10011111003333000101
10300001010001111101
1003300133333030B001
1003033300B103310031
10001110000103310331
10310033300100011331
10301111001030010331
10303333333303311111
1B301110000111303031
10010000000111003001
11111111111111111111
