20 15
11111111111111111111
10000011100000000001
10000011100000011101
10000000000000000011
10011111000000000101
10000001010001111101
10000001000000000001
10000000000100010001
10001110000100010001
10010000000100011001
10001111001000010001
10000000000000011111
10001110000111000001
10010000000111000001
11111111111111111111
