20 15
11111111111111111111
10303011133330033001
10003011100033311101
13300303030033330011
10011111003333000101
10300001010001111101
10033001333330300001
10030333000103310031
10001110000103310331
10310033300100011331
10301111001030010331
10303333333303311111
10301110000111303031
10010000000111003001
11111111111111111111
