20 15
11111111111111111111
100000111000000000B1
10000011100000011101
10000000000000000011
10011111000000000101
10000001010001111101
1000000100000000B001
1000000000B100010001
10001110000100010001
10010000000100011001
10001111001000010001
10000000000000011111
1B001110000111000001
10010000000111000001
11111111111111111111
