20 15
11111111111111111111
100000111000000000B1
10000011100000011101
10000000000000000011
10033333000000000101
10000003010003133101
1000000300000000B001
1000000000B300010001
10003330000300010001
10010000000100011001
10001133003000010001
10000000000000013111
1B001110000333000001
10010000000111000001
11111111111111111111
